11111111111111111111111111111111111111111111111111111111111111
1C0C100C000M0000C000M000C0000000000C0C100000000000E1
100M0101111111111111111111100M000101C0000M0011
1111101011000000000000000111111110000001000011111111
1C00M000C100000111C0000P00000100M0000100M0000000001
1111111111000000111100000000001111101111111100001
100C000C01000000M00000011011000100C1CC1C110000C001
1C000001C0000001110001110001001010C1CC1C100C00000M000C1
11000C110C01110000000C0C0010010C1CC1000011111111111111
10000110001000000111111000C10111111C000000000C1
1000M00M0000000000001000M000C00CC1000C1C00000M01
11111111111001100C00C001000111100M0001C00M00001CC11111
1C00000001CC10000M000000110011111101111110001C0M0C1C0001
100M000001000111111111111C00C0C000000M0011111111001
11111110010000000M000C100M001100000C11100M0000001
1CCCCCC000000001111100011111100111100C111111111110C1
1000M000M000M0M0000M0000C000M0000C00M00C111C00M0000M0000C1
11111111111111111111111111111111111111111111111111111111111111