11111111111111111111111111111111111111111111111111111111111111
1C0000C100C00000000C0000000C0000000000000C000C10000000000000E1
10000001011111111111111111111000000000000100001C00000000000011
111110010110000000P0000000001111111100000000001000000011111111
1C000000C10000000000111C00000000000010000000001000000000000001
11111111110000000000001111000000000000011111011111111000000001
100C000C010000000000000000110110001000C1C0C1C110000C0000000001
1C00000001C000000011100011100010010100C1C0C1C100C00000000000C1
11000000C11000C011100000000C0C00100010C1C0C1000011111111111111
1000000011000010000000000111111000000C1000111111C00000000000C1
1000000000000000000000000100000000C00CC1000000C1C0000000000001
11111111111001100C000C00100011110000001C00000001C00000C1001111
1C00000000001CC1000000000001100011111101111110001C000C1C000001
100000000001000111111111111C00C0000C00000000000001111111100001
11111110001000000000000000C10000001100000000C11100000000000001
1CCCCCC000000000000011111000111111001111000C1111111111100000C1
100000000000000000000000000C00000000C00000C111C0000000000000C1
11111111111111111111111111111111111111111111111111111111111111