111111111
100C00001
1C1110001
100110001
1P00C00E1
111111111
